          _____                    _____                    _____                    _____                                  
         /\    \                  /\    \                  /\    \                  /\    \                 ______          
        /::\    \                /::\    \                /::\    \                /::\    \               |::|   |         
       /::::\    \              /::::\    \              /::::\    \               \:::\    \              |::|   |         
      /::::::\    \            /::::::\    \            /::::::\    \               \:::\    \             |::|   |         
     /:::/\:::\    \          /:::/\:::\    \          /:::/\:::\    \               \:::\    \            |::|   |         
    /:::/__\:::\    \        /:::/__\:::\    \        /:::/  \:::\    \               \:::\    \           |::|   |         
   /::::\   \:::\    \      /::::\   \:::\    \      /:::/    \:::\    \              /::::\    \          |::|   |         
  /::::::\   \:::\    \    /::::::\   \:::\    \    /:::/    / \:::\    \    ____    /::::::\    \         |::|   |         
 /:::/\:::\   \:::\____\  /:::/\:::\   \:::\    \  /:::/    /   \:::\ ___\  /\   \  /:::/\:::\    \  ______|::|___|___ ____ 
/:::/  \:::\   \:::|    |/:::/  \:::\   \:::\____\/:::/____/     \:::|    |/::\   \/:::/  \:::\____\|:::::::::::::::::|    |
\::/   |::::\  /:::|____|\::/    \:::\  /:::/    /\:::\    \     /:::|____|\:::\  /:::/    \::/    /|:::::::::::::::::|____|
 \/____|:::::\/:::/    /  \/____/ \:::\/:::/    /  \:::\    \   /:::/    /  \:::\/:::/    / \/____/  ~~~~~~|::|~~~|~~~      
       |:::::::::/    /            \::::::/    /    \:::\    \ /:::/    /    \::::::/    /                 |::|   |         
       |::|\::::/    /              \::::/    /      \:::\    /:::/    /      \::::/____/                  |::|   |         
       |::| \::/____/               /:::/    /        \:::\  /:::/    /        \:::\    \                  |::|   |         
       |::|  ~|                    /:::/    /          \:::\/:::/    /          \:::\    \                 |::|   |         
       |::|   |                   /:::/    /            \::::::/    /            \:::\    \                |::|   |         
       \::|   |                  /:::/    /              \::::/    /              \:::\____\               |::|   |         
        \:|   |                  \::/    /                \::/____/                \::/    /               |::|___|         
         \|___|                   \/____/                  ~~                       \/____/                 ~~              
                                                                                                                   

Congratulations on installing Radix on your Kubernetes cluster!

Go to https://radixgrafana.azurewebsites.net/d/ReuNR5Aik/radix-public-endpoint-status?var-Cluster={{ .Values.testing.clusterFQDN }} to see the status of your cluster.
